###########################################################################
# #     #       # #             #                           #     #   #   #
# ##### # ### # # ####### ##### ##################### ### ### # ### # # # #
# #   #     # # #   #   #     #   #           #     #   # #   #   # #   # #
# # # ##### # # ##### # ##### ### # ######### # ### ### ### ##### # ##### #
#   #     # # #       #       # #   #       # # # #   #     #   #       # #
######### ### ### # ########### ##### # ##### # # ### ##### # # ######### #
# #     # #   # # # #     #     #     #       # #     #   #   #         # #
# # # ### # ### # # # ### # ### # ############# # ##### # ######## ## ### #
#   #       #     # #   #     #                 #       #          #  #E  #
###########################################################################
