################################
# #      #           # #       #
# # # #### # ####### # ##### ###
# # # #    # #     # #         #
# ### ###### ##### ### ####### #
#                    # #E    # #
# ################## # ##### # #
# #                       #    #
################################